###s##
#....#
#...##
##..##
###.##
###e##
