#####s###
#.......#
#####.#.#
#.....###
#.#####.#
#.......#
#####.###
#.......#
#.#####.#
#.....###
#####.#.#
#.......#
#####e###
