###s###
#.....#
#...###
##...##
####e##
