#####s###
#.......#
#.###.###
#.#.#...#
#.#.#####
#.......#
#####e###
