#####s###
#.......#
#.###.###
#.#.#...#
#.#.#####
#.......#
#####e###
#.......#
#.#.#####
#.#.#...#
#.###.###
#.......#
#####s###
